World 4
1 53 106 157 210
264
shakespeare
Shakespeare1.png Shakespeare2.png Shakespeare3.png Shakespeare4.png Shakespeare5.png
ShakespeareQ.png
gravedigger
1                                                                                                                                                                                                                                                                      1
1                                                                                                                                                                                                                                                                      1
1                                                                                                                                                                                                                                                                      1
1                             0000000                                                          L                                                                                                                                                                       1
1                             1111111                                                                                                                                                                                                                                  1
1                             BBBBBBB                                     1111                                                              1111                                                                                                                       1
1                                                                                                                                       1                                                                                      1                                       1
1                                                                       1        1111111111                                          1                                                                                                                                 1
1           00000     0   00000                                       1                                             1111   1    1               1111                                     2                                 1                 1        1                1
1                         01110                                      1                                             1                                                                22  000                                                     1                      1
1 0000000                 01110                                                      1111111111       111                                                                     2    0000 000                            1                 1                             1
1                         01110                                1111111                              1 111        1111111 222222222  1111                   L                 000   0000 000                                                               1            1
1           00000         01110                                                                       111                                             000000                 000   0000 000  000                    1                1                          1      1
1                         01110                           1111111                              1111   111    111                                        11        00000   000000   0000 000  000   111                                                                  
1 00000000    0000000000  01110               L                                                       111                                               11       11111BBBB000000BBB0000B000BB000  111  2121    L  12B2B2B2B2B2B2B2B2B2B2B2             2B2B2B2B2B       
1A00000000BBBB000000000000000000BB0000000000000000000A000BBBBBBBBBBBBBBBBBBBBBBBBBBBBBBBBBBBBBBBBBB000000A000000000000000000000000000000000000000000000000000A0000000000000000000000000000000000000000000000000000A00000000000000000000000B          B000000000000000001
11111111111111111111111111111111111111111111111111111111111111111111111111111111111111111111111111111111111111111111111111111111111111111111111111111111111111111111111111111111111111111111111111111111111111111111111111111111111111111111B       B1111111111111111111
111111111111111111111111111111111111111111111111111111111111111111111111111111111111111111111111111111111111111111111111111111111111111111111111111111111111111111111111111111111111111111111111111111111111111111111111111111111111111111111B     B11111111111111111111
1111111111111111111111111111111111111111111111111111111111111111111111111111111111111111111111111111111111111111111111111111111111111111111111111111111111111111111111111111111111111111111111111111111111111111111111111111111111111111111111BBBBB111111111111111111111