World 2
1 54 109 162 209
264
king
King1.png King2.png King3.png King4.png King5.png
KingQ.png
shining
1                                                                                                                                                                                                                                                                      1
1                                                                                                                                                                                                                                                                      1
1                                                                                                                                                                                                                                     11111111111                      1
1                                                                                                                                                                                                                                    1                                 1
1                                                                                                                                                                                                                                   1                                  1
1                                                                                                                                                                                                                L                 1                                   1
1                                                                                                                      111                                                                                     111                1                  1                 1
1                                                                      111                                                111                                                                                 1                  1                                     1
1                                                                    111                    L                    111                      111                                                                1                  1                                      1
1                                                                  111                 111  11  111                           111      111                                                                  1                  1                                       1
1                                                                111       111     111                               1            1111                                            111        111         111                  1                             1          1
1                                      1                       111                                111                                        111                                                                             1                                         1
1          111   111   111          1   1                     11               111                   111                111                       111                        111     11111111    11111111           1       1                                    1     1
1       111               111    1       1                                                              1                                           111                                                             1                                            1      
1    111                     111          1        L       11                                            1          111                               111 L              111                                        1     1                                      1 L    
1A  0000000000   0000000000000000000000000000000000000A0000000000000000000000000000000000000000000000000000A000000000000000000000000000000000000000000000000000000A0000000000000000000000000000000000000000000000000000A000000000000000000000000000000000000000000000001
11               1111111111111111111111111111111111111111111111111111111111111111111111111111111111111111111111111111111111111111111111111111111111111111111111111111111111111111111111111111111111111111111111111111111111111111111111111111111111111111111111111111111
111             11111111111111111111111111111111111111111111111111111111111111111111111111111111111111111111111111111111111111111111111111111111111111111111111111111111111111111111111111111111111111111111111111111111111111111111111111111111111111111111111111111111
111111111111111111111111111111111111111111111111111111111111111111111111111111111111111111111111111111111111111111111111111111111111111111111111111111111111111111111111111111111111111111111111111111111111111111111111111111111111111111111111111111111111111111111111