World 1
1 51 106 157 209
264
poe
Poe1.png Poe2.png Poe3.png Poe4.png Poe5.png
PoeQ.png
detective
1                                                                                                                                                                                                                                                                      1
1                                                                                                                                                                                                                                                                      1
1                                                                                                                                                                                                                                                                      1
1                                                                                                                                                                                                                 do_not_fall_lest_you                                 1
1                                                                                                          avoid_spikes_they_hurt                                                                                 __meet_your_demise__                                 1
1 use_a_and_d_or_the                                use_w_or_space_or_up                                   if_you_have_the_letter                              avoid_the_lava_or_                                                                                      1
1 arrow_keys_to_move                                _arrow_to_jump_over_                                   __before_each_golden__                              water_it_will_kill                                                                                      1
1 letters_give_hints                                terrain_or_obstacles                                   checkpoint_you_will_re                              ___you_as_well____                                                                                      1
1 _for_puzzles_pick_                                                                                       spawn_there_if_you_die                                                                                                                                      1
1 ______them_up_____                                                                                                                                                                                                             1111                                  1
1                                                                                                                                                                                                                          11111      11111                            1
1                                                                                                                                                                                                                         1                1                           1
1                                                                                                                                                                             11111    111                               1                  1                          1
1                                                                                                                                                                          1              1                             1                    1                          
1                                               L     1   1   1   1   1   1   1   1   1   1   1   1   1 L       2     2     2     2     2     2     2  L  2      1   1   1                 1              L            1                       22                       
1A0000000000000000000000000000000000000000000000000A000000000000000000000000000000000000000000000000000000A00000000000000000000000000000000000000000000000000A0000000000000BBBBBBBBBBBBBBB00000000000000000000000A0000000                     000001    1000000000000001
1111111111111111111111111111111111111111111111111111111111111111111111111111111111111111111111111111111111111111111111111111111111111111111111111111111111111111111111111111111111111111111111111111111111111111111111111                     1111111 L11111111111111111
1111111111111111111111111111111111111111111111111111111111111111111111111111111111111111111111111111111111111111111111111111111111111111111111111111111111111111111111111111111111111111111111111111111111111111111111111                     11111111111111111111111111
1111111111111111111111111111111111111111111111111111111111111111111111111111111111111111111111111111111111111111111111111111111111111111111111111111111111111111111111111111111111111111111111111111111111111111111111111                     11111111111111111111111111